*******************************
*..*.....*..............*..*..*
*..*..*..*******..*******..*..*
*.....*....................*..*
****..*******************..*..*
*..*...........*..............*
*..*..*..**********..****..****
*.....*.....*..*..*..*.....*..*
*..*..****..*..*..*..*..*..*..*
*..*..*...........*..*..*.....*
*******************************